Afghanistan	Afghanistan	Afghanistan	Afghanistan
Aichi	Japan	Aichi	Aichi
Akita	Japan	Akita	Akita
Alabama	USA	Alabama	Alabama
Alaska	USA	Alaska	Alaska
Albania	Albania	Albania	Albania
Alberta	Canada	Alberta	Alberta
Algeria	Algeria	Algeria	Algeria
AliceSprings	Australia	NorthernTerritory	AliceSprings
AmericanSamoa	AmericanSamoa	AmericanSamoa	AmericanSamoa
Andaman	India	India	Andaman
Anguilla	Anguilla	Anguilla	Anguilla
Aomori	Japan	Aomori	Aomori
Aragon	Spain	Spain	Aragon
Argentina	Argentina	Argentina	Argentina
Arizona	USA	Arizona	Arizona
Arkansas	USA	Arkansas	Arkansas
Astrakhan	Russia	Russia	Astrakhan
Athens	Greece	Greece	Athens
Auckland	NewZealand	NewZealand	Auckland
BadenWurttemberg	Germany	Germany	BadenWurttemberg
Bahamas	Bahamas	Bahamas	Bahamas
Baleares	Spain	Spain	Baleares
Bangkok	Thailand	Thailand	Bangkok
Bangladesh	Bangladesh	Bangladesh	Bangladesh
Barbados	Barbados	Barbados	Barbados
Barcelona	Spain	Spain	Barcelona
Bayern	Germany	Germany	Bayern
Beijing	China	Beijing	Beijing
Belgium	Belgium	Belgium	Belgium
Berlin	Germany	Germany	Berlin
Bhutan	Bhutan	Bhutan	Bhutan
Bolivia	Bolivia	Bolivia	Bolivia
Bordeaux	France	France	Bordeaux
Brandenburg	Germany	Germany	Brandenburg
Bratislava	Slovakia	Slovakia	Bratislava
Brazil	Brazil	Brazil	Brazil
Bremen	Germany	Germany	Bremen
Bretagne	France	France	Bretagne
Brisbane	Australia	Queensland	Brisbane
BritishColumbia	Canada	BritishColumbia	BritishColumbia
Brussels	Belgium	Belgium	Brussels
Bucuresti	Romania	Romania	Bucuresti
Bulgaria	Bulgaria	Bulgaria	Bulgaria
Busan	SouthKorea	SouthKorea	Busan
California	USA	California	California
Cambodia	Cambodia	Cambodia	Cambodia
Cameroon	Cameroon	Cameroon	Cameroon
Canberra	Australia	Canberra	Canberra
CapeTown	SouthAfrica	SouthAfrica	CapeTown
Caracas	Venezuela	Venezuela	Caracas
CaymanIslands	CaymanIslands	CaymanIslands	CaymanIslands
Ceara	Brazil	Brazil	Ceara
Chachoengsao	Thailand	Thailand	Chachoengsao
Chanthaburi	Thailand	Thailand	Chanthaburi
Cheju	SouthKorea	SouthKorea	Cheju
Chennai	India	India	Chennai
Cheonbuk	SouthKorea	SouthKorea	Cheonbuk
Cheonnam	SouthKorea	SouthKorea	Cheonnam
Chiba	Japan	Chiba	Chiba
Chile	Chile	Chile	Chile
Chita	Russia	Russia	Chita
Choibalsan	Mongolia	Mongolia	Choibalsan
Chongqing	China	Chongqing	Chongqing
Christchurch	NewZealand	NewZealand	Christchurch
Chungbuk	SouthKorea	SouthKorea	Chungbuk
Chungnam	SouthKorea	SouthKorea	Chungnam
Chuuk	Micronesia	Micronesia	Chuuk
Cluj	Romania	Romania	Cluj
Colombia	Colombia	Colombia	Colombia
Colorado	USA	Colorado	Colorado
Connecticut	USA	Connecticut	Connecticut
Cordoba	Spain	Spain	Cordoba
CostaRica	CostaRica	CostaRica	CostaRica
Cuba	Cuba	Cuba	Cuba
Cyprus	Cyprus	Cyprus	Cyprus
Daegu	SouthKorea	SouthKorea	Daegu
Daejeon	SouthKorea	SouthKorea	Daejeon
Dakar	Senegal	Senegal	Dakar
Darwin	Australia	NorthernTerritory	Darwin
Deajeon	SouthKorea	SouthKorea	Deajeon
Delaware	USA	Delaware	Delaware
Delhi	India	India	Delhi
Denmark	Denmark	Denmark	Denmark
Dibrugarh	India	India	Dibrugarh
DistrictOfColumbia	USA	DistrictOfColumbia	DistrictOfColumbia
Dnipropetrovsk	Ukraine	Ukraine	Dnipropetrovsk
DominicanRepublic	DominicanRepublic	DominicanRepublic	DominicanRepublic
Donetsk	Ukraine	Ukraine	Donetsk
Dornogobi	Mongolia	Mongolia	Dornogobi
Dunedin	NewZealand	NewZealand	Dunedin
Ecuador	Ecuador	Ecuador	Ecuador
Egypt	Egypt	Egypt	Egypt
Ehime	Japan	Ehime	Ehime
Ekaterinburg	Russia	Russia	Ekaterinburg
ElSalvador	ElSalvador	ElSalvador	ElSalvador
England	UnitedKingdom	UnitedKingdom	England
Inverness	UnitedKingdom	UnitedKingdom	Inverness
Erzurum	Turkey	Turkey	Erzurum
Esfahan	Iran	Iran	Esfahan
Estonia	Estonia	Estonia	Estonia
Ethiopia	Ethiopia	Ethiopia	Ethiopia
Euskadi	Spain	Spain	Euskadi
Fes	Morocco	Morocco	Fes
Fiji	Fiji	Fiji	Fiji
Finland	Finland	Finland	Finland
Firenze	Italy	Italy	Firenze
Florida	USA	Florida	Florida
Guiana	FrenchGuiana	FrenchGuiana	FrenchGuiana
Fujian	China	Fujian	Fujian
Fukui	Japan	Fukui	Fukui
Fukuoka	Japan	Fukuoka	Fukuoka
Fukushima	Japan	Fukushima	Fukushima
Galati	Romania	Romania	Galati
Gangwon	SouthKorea	SouthKorea	Gangwon
Gansu	China	Gansu	Gansu
Geneva	Switzerland	Switzerland	Geneva
Genoa	Italy	Italy	Genoa
Georgia	USA	Georgia	Georgia
Germany	Germany	Germany	Germany
Ghana	Ghana	Ghana	Ghana
Ghazivin	Iran	Iran	Ghazivin
Gibraltar	Gibraltar	Gibraltar	Gibraltar
Gifu	Japan	Gifu	Gifu
Greece	Greece	Greece	Greece
Grenoble	France	France	Grenoble
Guadeloupe	Guadeloupe	Guadeloupe	Guadeloupe
Guam	Guam	Guam	Guam
Guangdong	China	Guangdong	Guangdong
Guangxi	China	Guangxi	Guangxi
Guangzhou	China	Guangdong	Guangzhou
Guatemala	Guatemala	Guatemala	Guatemala
Guizhou	China	Guizhou	Guizhou
Gunma	Japan	Gunma	Gunma
Gyeonggi	SouthKorea	SouthKorea	Gyeonggi
Gyeongnam	SouthKorea	SouthKorea	Gyeongnam
Haiti	Haiti	Haiti	Haiti
Hannover	Germany	Germany	Hannover
Harbin	China	Heilongjiang	Harbin
Hawaii	USA	Hawaii	Hawaii
Heilongjiang	China	Heilongjiang	Heilongjiang
Henan	China	Henan	Henan
Hessen	Germany	Germany	Hessen
Hiroshima	Japan	Hiroshima	Hiroshima
Hmelnizk	Ukraine	Ukraine	Hmelnizk
Hokkaido	Japan	Hokkaido	Hokkaido
Honduras	Honduras	Honduras	Honduras
HongKong	HongKong	HongKong	HongKong
Hubei	China	Hubei	Hubei
Hyogo	Japan	Hyogo	Hyogo
Ibaraki	Japan	Ibaraki	Ibaraki
Iceland	Iceland	Iceland	Iceland
Idaho	USA	Idaho	Idaho
Illinois	USA	Illinois	Illinois
Incheon	SouthKorea	SouthKorea	Incheon
Indiana	USA	Indiana	Indiana
Indonesia	Indonesia	Indonesia	Indonesia
Iowa	USA	Iowa	Iowa
Ireland	Ireland	Ireland	Ireland
Ishikawa	Japan	Ishikawa	Ishikawa
Israel	Israel	Israel	Israel
Italy	Italy	Italy	Italy
Ivacevichi	Belarus	Belarus	Ivacevichi
IvoryCoast	IvoryCoast	IvoryCoast	IvoryCoast
Iwate	Japan	Iwate	Iwate
Jamaica	Jamaica	Jamaica	Jamaica
Japan	Japan	Japan	Japan
Jaroslavl	Russia	Russia	Jaroslavl
Jeju	SouthKorea	SouthKorea	Jeju
Jeonbuk	SouthKorea	SouthKorea	Jeonbuk
Jiangsu	China	Jiangsu	Jiangsu
Jiangxi	China	Jiangxi	Jiangxi
Jilin	China	Jilin	Jilin
Johannesburg	SouthAfrica	SouthAfrica	Johannesburg
Kagawa	Japan	Kagawa	Kagawa
Kagoshima	Japan	Kagoshima	Kagoshima
Kaliningrad	Russia	Russia	Kaliningrad
Kamphaengphet	Thailand	Thailand	Kamphaengphet
Kanagawa	Japan	Kanagawa	Kanagawa
Kawasaki	Japan	Kanagawa	Kawasaki
Kemerovo	Russia	Russia	Kemerovo
Kentucky	USA	Kentucky	Kentucky
Kenya	Kenya	Kenya	Kenya
Khabarovsk	Russia	Russia	Khabarovsk
Khmelnitsky	Ukraine	Ukraine	Khmelnitsky
Kiev	Ukraine	Ukraine	Kiev
Kiribati	Kiribati	Kiribati	Kiribati
Kitakyushu	Japan	Fukuoka	Kitakyushu
Kobe	Japan	Hyogo	Kobe
Kochi	Japan	Kochi	Kochi
Kolkutta	India	India	Kolkutta
Kumamoto	Japan	Kumamoto	Kumamoto
Kuwait	Kuwait	Kuwait	Kuwait
Kwangju	SouthKorea	SouthKorea	Kwangju
Kyongbuk	SouthKorea	SouthKorea	Kyongbuk
Kyoto	Japan	Kyoto	Kyoto
Kyunggi	SouthKorea	SouthKorea	Kyunggi
Kyungnam	SouthKorea	SouthKorea	Kyungnam
Labrador	Canada	Labrador	Labrador
Laos	Laos	Laos	Laos
Latur	India	India	Latur
Latvia	Latvia	Latvia	Latvia
Leon	Spain	Spain	Leon
Liaoning	China	Liaoning	Liaoning
Limoges	France	France	Limoges
Lipetsk	Russia	Russia	Lipetsk
Lisboa	Portugal	Portugal	Lisboa
LopBuri	Thailand	Thailand	LopBuri
Louisiana	USA	Louisiana	Louisiana
Luxembourg	Luxembourg	Luxembourg	Luxembourg
Lyon	France	France	Lyon
Macau	Macau	Macau	Macau
Madagascar	Madagascar	Madagascar	Madagascar
MaeHongSon	Thailand	Thailand	MaeHongSon
Maine	USA	Maine	Maine
Malaysia	Malaysia	Malaysia	Malaysia
Manitoba	Canada	Manitoba	Manitoba
Marseille	France	France	Marseille
Martinique	Martinique	Martinique	Martinique
Maryland	USA	Maryland	Maryland
Massachusetts	USA	Massachusetts	Massachusetts
Mauritius	Mauritius	Mauritius	Mauritius
Memphis	USA	Tennessee	Memphis
Mexico	Mexico	Mexico	Mexico
Michigan	USA	Michigan	Michigan
Mie	Japan	Mie	Mie
Minnesota	USA	Minnesota	Minnesota
Minsk	Belarus	Belarus	Minsk
Mississippi	USA	Mississippi	Mississippi
Missouri	USA	Missouri	Missouri
Miyagi	Japan	Miyagi	Miyagi
Miyazaki	Japan	Miyazaki	Miyazaki
Moldova	Moldova	Moldova	Moldova
Montana	USA	Montana	Montana
Montevideo	Uruguay	Uruguay	Montevideo
Morobe	PapuaNewGuinea	PapuaNewGuinea	Morobe
Moscow	Russia	Russia	Moscow
Murcia	Spain	Spain	Murcia
Nagano	Japan	Nagano	Nagano
Nagasaki	Japan	Nagasaki	Nagasaki
Nagoya	Japan	Aichi	Nagoya
Nakhonratchasima	Thailand	Thailand	Nakhonratchasima
Nanded	India	India	Nanded
Nara	Japan	Nara	Nara
Nashik	India	India	Nashik
Nebraska	USA	Nebraska	Nebraska
NeiMongol	China	Neimenggu	Neimenggu
Nepal	Nepal	Nepal	Nepal
Netherlands	Netherlands	Netherlands	Netherlands
Nevada	USA	Nevada	Nevada
NewBrunswick	Canada	NewBrunswick	NewBrunswick
NewCaledonia	NewCaledonia	NewCaledonia	NewCaledonia
Newcastle	Australia	NewSouthWales	Newcastle
Newfoundland	Canada	Newfoundland	Newfoundland
NewHampshire	USA	NewHampshire	NewHampshire
NewJersey	USA	NewJersey	NewJersey
NewMexico	USA	NewMexico	NewMexico
NewSouthWales	Australia	NewSouthWales	NewSouthWales
NewYork	USA	NewYork	NewYork
Nicaragua	Nicaragua	Nicaragua	Nicaragua
Nice	France	France	Nice
Nigeria	Nigeria	Nigeria	Nigeria
Niigata	Japan	Niigata	Niigata
Ningbo	China	Zhejiang	Ningbo
Ningxia	China	Ningxia	Ningxia
NongKhai	Thailand	Thailand	NongKhai
Nonthaburi	Thailand	Thailand	Nonthaburi
NordrheinWestfalen	Germany	Germany	NordrheinWestfalen
NorthCarolina	USA	NorthCarolina	NorthCarolina
NorthDakota	USA	NorthDakota	NorthDakota
NorthernMarianasIslands	NorthernMarianaIslands	NorthernMarianaIslands	NorthernMarianaIslands
NorthernTerritory	Australia	NorthernTerritory	NorthernTerritory
Norway	Norway	Norway	Norway
NovaScotia	Canada	NovaScotia	NovaScotia
Novosibirsk	Russia	Russia	Novosibirsk
Ohio	USA	Ohio	Ohio
Oita	Japan	Oita	Oita
Okayama	Japan	Okayama	Okayama
Okinawa	Japan	Okinawa	Okinawa
Oklahoma	USA	Oklahoma	Oklahoma
Omsk	Russia	Russia	Omsk
Ontario	Canada	Ontario	Ontario
Oregon	USA	Oregon	Oregon
Osaka	Japan	Osaka	Osaka
Oslo	Norway	Norway	Oslo
Otago	NewZealand	NewZealand	Otago
Padova	Italy	Italy	Padova
Panama	Panama	Panama	Panama
Paraguay	Paraguay	Paraguay	Paraguay
Paris	France	France	Paris
Parma	Italy	Italy	Parma
Peloponnese	Greece	Greece	Peloponnese
Pennsylvania	USA	Pennsylvania	Pennsylvania
Perth	Australia	WesternAustralia	Perth
Perugia	Italy	Italy	Perugia
Philippines	Philippines	Philippines	Philippines
Poitiers	France	France	Poitiers
Prague	CzechRepublic	CzechRepublic	Prague
PrinceEdwardIsland	Canada	PrinceEdwardIsland	PrinceEdwardIsland
PuertoRico	PuertoRico	PuertoRico	PuertoRico
Pune	India	India	Pune
Pusan	SouthKorea	SouthKorea	Pusan
Qinghai	China	Qinghai	Qinghai
Quebec	Canada	Quebec	Quebec
Queensland	Australia	Queensland	Queensland
Ratnagiri	India	India	Ratnagiri
RheinlandPfalz	Germany	Germany	RheinlandPfalz
RhodeIsland	USA	RhodeIsland	RhodeIsland
Romania	Romania	Romania	Romania
Rosario	Argentina	Argentina	Rosario
Sabac	Serbia	Serbia	Sabac
Saga	Japan	Saga	Saga
Sainshand	Mongolia	Mongolia	Sainshand
Saitama	Japan	Saitama	Saitama
Sakai	Japan	Osaka	Sakai
Salamanca	Spain	Spain	Salamanca
Sangali	Philippines	Philippines	Sangali
Santiago	Chile	Chile	Santiago
Sapporo	Japan	Hokkaido	Sapporo
Saraburi	Thailand	Thailand	Saraburi
Saskatchewan	Canada	Saskatchewan	Saskatchewan
Scotland	UnitedKingdom	UnitedKingdom	Scotland
Sendai	Japan	Miyagi	Sendai
Seoul	SouthKorea	SouthKorea	Seoul
Shaanxi	China	Shaanxi	Shaanxi
Shandong	China	Shandong	Shandong
Shanghai	China	Shanghai	Shanghai
Shantou	China	Guangdong	Shantou
Shanxi	China	Shanxi	Shanxi
Shenzhen	China	Guangdong	Shenzhen
Shimane	Japan	Shimane	Shimane
Shizuoka	Japan	Shizuoka	Shizuoka
Sichuan	China	Sichuan	Sichuan
Singapore	Singapore	Singapore	Singapore
Slovenia	Slovenia	Slovenia	Slovenia
Sofia	Bulgaria	Bulgaria	Sofia
SolomonIslands	SolomonIslands	SolomonIslands	SolomonIslands
Songkhla	Thailand	Thailand	Songkhla
SouthAuckland	NewZealand	NewZealand	SouthAuckland
SouthAustralia	Australia	SouthAustralia	SouthAustralia
SouthCarolina	USA	SouthCarolina	SouthCarolina
SouthDakota	USA	SouthDakota	SouthDakota
SouthKorea	SouthKorea	SouthKorea	SouthKorea
Spain	Spain	Spain	Spain
SriLanka	SriLanka	SriLanka	SriLanka
Stockholm	Sweden	Sweden	Stockholm
StPetersburg	Russia	Russia	StPetersburg
Sukhbaatar	Mongolia	Mongolia	Sukhbaatar
SuratThani	Thailand	Thailand	SuratThani
Suriname	Suriname	Suriname	Suriname
Sweden	Sweden	Sweden	Sweden
Switzerland	Switzerland	Switzerland	Switzerland
Sydney	Australia	NewSouthWales	Sydney
Syria	Syria	Syria	Syria
Taiwan	Taiwan	Taiwan	Taiwan
Tanger	Morocco	Morocco	Tanger
Tanzania	Tanzania	Tanzania	Tanzania
Tasmania	Australia	Tasmania	Tasmania
Tehran	Iran	Iran	Tehran
Tennessee	USA	Tennessee	Tennessee
Texas	USA	Texas	Texas
Thailand	Thailand	Thailand	Thailand
Thessaloniki	Greece	Greece	Thessaloniki
Thuringen	Germany	Germany	Thuringen
Tianjin	China	Tianjin	Tianjin
Tochigi	Japan	Tochigi	Tochigi
Tokushima	Japan	Tokushima	Tokushima
Tokyo	Japan	Tokyo	Tokyo
Torino	Italy	Italy	Torino
Tottori	Japan	Tottori	Tottori
Toulon	France	France	Toulon
Townsville	Australia	Queensland	Townsville
Toyama	Japan	Toyama	Toyama
Trieste	Italy	Italy	Trieste
Tunisia	Tunisia	Tunisia	Tunisia
Turkey	Turkey	Turkey	Turkey
Uganda	Uganda	Uganda	Uganda
Ukraine	Ukraine	Ukraine	Ukraine
Ulaanbaatar	Mongolia	Mongolia	Ulaanbaatar
UlanUde	Russia	Russia	UlanUde
Ulsan	SouthKorea	SouthKorea	Ulsan
Umea	Sweden	Sweden	Umea
UnitedKingdom	UnitedKingdom	UnitedKingdom	UnitedKingdom
Uruguay	Uruguay	Uruguay	Uruguay
Ushuaia	Argentina	Argentina	Ushuaia
Utah	USA	Utah	Utah
Uvurkhangai	Mongolia	Mongolia	Uvurkhangai
Vellore	India	India	Vellore
Venezuela	Venezuela	Venezuela	Venezuela
Vermont	USA	Vermont	Vermont
Victoria	Australia	Victoria	Victoria
Vietnam	Vietnam	Vietnam	Vietnam
VirginIslands	USA	VirginIslands	VirginIslands
Vladimir	Russia	Russia	Vladimir
Volos	Greece	Greece	Volos
Voronezh	Russia	Russia	Voronezh
Waikato	NewZealand	NewZealand	Waikato
Wakayama	Japan	Wakayama	Wakayama
Wallonia	Belgium	Belgium	Wallonia
Washington	USA	Washington	Washington
Wellington	NewZealand	NewZealand	Wellington
WesternAustralia	Australia	WesternAustralia	WesternAustralia
WesternSepik	PapuaNewGuinea	PapuaNewGuinea	WesternSepik
WestVirginia	USA	WestVirginia	WestVirginia
Wisconsin	USA	Wisconsin	Wisconsin
Wuhan	China	Hubei	Wuhan
Wuzhou	China	Guangxi	Wuzhou
Wyoming	USA	Wyoming	Wyoming
Xiamen	China	Fujian	Xiamen
Xinjiang	China	Xinjiang	Xinjiang
Yamagata	Japan	Yamagata	Yamagata
Yamaguchi	Japan	Yamaguchi	Yamaguchi
Yamanashi	Japan	Yamanashi	Yamanashi
Yaroslavl	Russia	Russia	Yaroslavl
Yokohama	Japan	Kanagawa	Yokohama
Yunnan	China	Yunnan	Yunnan
Zagreb	Croatia	Croatia	Zagreb
Zhejiang	China	Zhejiang	Zhejiang
Zrenjanin	Serbia	Serbia	Zrenjanin
CotedIvoire	IvoryCoast	IvoryCoast	IvoryCoast
Guyane	FrenchGuiana	FrenchGuiana	FrenchGuiana
Nothaburi	Thailand	Thailand	Nonthaburi
Hunan	China	Hunan	Hunan
Beijng	China	Beijing	Beijing
BadenWuerttemburg	Germany	Germany	BadenWurttemberg
Korea	SouthKorea	SouthKorea	SouthKorea
Managua	Nicaragua	Nicaragua	Managua
Xinjing	China	Xinjiang	Xinjiang
Macedonia	Macedonia	Macedonia	Macedonia
Vladivostok	Russia	Russia	Vladivostok
Iraq	Iraq	Iraq	Iraq
Canterbury	NewZealand	NewZealand	Canterbury
Hamedan	Iran	Iran	Hamedan
Valparaiso	Chile	Chile	Valparaiso
Montserrat	Montserrat	Montserrat	Montserrat
Kazakhstan	Kazakhstan	Kazakhstan	Kazakhstan
Lisbon	Portugal	Portugal	Lisbon
Suphanburi	Thailand	Thailand	SuphanBuri
Hungary	Hungary	Hungary	Hungary
Naghpur	India	India	Naghpur
Krasnoyarsk	Russia	Russia	Krasnoyarsk
Massachussetts	USA	Massachusetts	Massachusetts
Boston	USA	Massachusetts	Massachusetts
Kisii	Kenya	Kenya	Kisii
Tula	Russia	Russia	Tula
Orkhon	Mongolia	Mongolia	Orkhon
Azarbayejan	Azerbaijan	Azerbaijan	Azerbaijan
Qatar	Qatar	Qatar	Qatar
Toulouse	France	France	Toulouse
Kisumu	Kenya	Kenya	Kisumu
Mongolia	Mongolia	Mongolia	Mongolia
Prachinburi	Thailand	Thailand	PrachinBuri
Constanta	Romania	Romania	Constanta
Isiolo	Kenya	Kenya	Isiolo
Birjand	Iran	Iran	Birjand
Kursk	Russia	Russia	Kursk
Coyhaique	Chile	Chile	Coyhaique
Khorasan	Iran	Iran	Khorasan
Cherkasy	Ukraine	Ukraine	Cherkasy
Leiden	Netherlands	Netherlands	Leiden
Kyrgyzstan	Kyrgyzstan	Kyrgyzstan	Kyrgyzstan
Heilongijang	China	Heilongjiang	Heilongjiang
Neimenggu	China	Neimenggu	Neimenggu
Kericho	Kenya	Kenya	Kericho
Daejeion	SouthKorea	SouthKorea	Daejeon
Sakaew	Thailand	Thailand	Sakaew
Chelyabinsk	Russia	Russia	Chelyabinsk
Arkhangelsk	Russia	Russia	Arkhangelsk
Khozestan	Iran	Iran	Khuzestan
Yuelu	China	Hunan	Yuelu
Belem	Brazil	Brazil	Belem
Mazandaran	Iran	Iran	Mazandaran
Iasi	Romania	Romania	Iasi
Kangwon	SouthKorea	SouthKorea	Gangwon
Gholestan	Iran	Iran	Gholestan
Yazd	Iran	Iran	Yazd
Ayutthaya	Thailand	Thailand	Ayutthaya
Ratchaburi	Thailand	Thailand	Ratchaburi
Ostrava	CzechRepublic	CzechRepublic	Ostrava
Mbagathi	Kenya	Kenya	Mbagathi
Samara	Russia	Russia	Samara
Tabriz	Iran	Iran	Tabriz
Luhansk	Ukraine	Ukraine	Luhansk
Myanmar	Myanmar	Myanmar	Myanmar
Piura	Peru	Peru	Piura
Tumbes	Peru	Peru	Tumbes
Maldonado	Uruguay	Uruguay	Maldonado
Houston	USA	Texas	Houston
Cusco	Peru	Peru	Cusco
RioDeJaneiro	Brazil	Brazil	RioDeJaneiro
Guayas	Ecuador	Ecuador	Guayas
Genova	Italy	Italy	Genoa
Slovakia	Slovakia	Slovakia	Slovakia
Milan	Italy	Italy	Milan
Kharkov	Ukraine	Ukraine	Kharkov
Sullana	Peru	Peru	Sullana
Juliaca	Peru	Peru	Juliaca
PapuaNewGuinea	PapuaNewGuinea	PapuaNewGuinea	PapuaNewGuinea
Concepcion	Chile	Chile	Concepcion
Temple	USA	Pennsylvania	Temple
Yurimaguas	Peru	Peru	Yurimaguas
Chanchamayo	Peru	Peru	Chanchamayo
Guayaquil	Ecuador	Ecuador	Guayaquil
Pucallpa	Peru	Peru	Pucallpa
StLucia	SaintLucia	SaintLucia	SaintLucia
Ancon	Peru	Peru	Ancon
Arequipa	Peru	Peru	Arequipa
Puno	Peru	Peru	Puno
Belgrade	Serbia	Serbia	Belgrade
Talcahuano	Chile	Chile	Talcahuano
CookIslands	CookIslands	CookIslands	CookIslands
Siena	Italy	Italy	Siena
Jordan	Jordan	Jordan	Jordan
Canarias	CanaryIslands	CanaryIslands	CanaryIslands
Iquitos	Peru	Peru	Iquitos
LosAngeles	USA	California	LosAngeles
Odessa	Ukraine	Ukraine	Odessa
Nairobi	Kenya	Kenya	Nairobi
Iquique	Chile	Chile	Iquique
Phitsanulok	Thailand	Thailand	Phitsanulok
Dniprodzerzinsk	Ukraine	Ukraine	Dniprodzerzhynsk
Cochabamba	Bolivia	Bolivia	Cochabamba
Uzbekistan	Uzbekistan	Uzbekistan	Uzbekistan
Khmelnytskyi	Ukraine	Ukraine	Khmelnytskyi
Trinidad	TrinidadTobago	TrinidadTobago	TrinidadTobago
Rivne	Ukraine	Ukraine	Rivne
Antofagasta	Chile	Chile	Antofagasta
Novgorod	Russia	Russia	Novgorod
Goroka	PapuaNewGuinea	PapuaNewGuinea	Goroka
Junin	Peru	Peru	Junin
Zamora	Spain	Spain	Spain
Wulumuqi	China	Xinjiang	Urumqi
Shiraz	Iran	Iran	Iran
Austria	Austria	Austria	Austria
Babol	Iran	Iran	Iran
Bahia	Brazil	Brazil	Bahia
Bogota	Colombia	Colombia	Bogota
Casablanca	Morocco	Morocco	Casablanca
Corsica	France	France	Corsica
Cheongju	SouthKorea	SouthKorea	Cheongju
Andalucia	Spain	Spain	Andalucia
Ashburton	NewZealand	NewZealand	Ashburton
CastillaLaMancha	Spain	Spain	CastillaLaMancha
Extremadura	Spain	Spain	Extremadura
Galicia	Spain	Spain	Galicia
Evros	Greece	Greece	Evros
Boshehr	Iran	Iran	Boshehr
Hanoi	Vietnam	Vietnam	Hanoi
Alexandroupolis	Greece	Greece	Alexandroupolis
Acre	Brazil	Brazil	Acre
Alupe	Kenya	Kenya	Alupe
Assam	India	India	Assam
BacNinh	Vietnam	Vietnam	BacNinh
BacGiang	Vietnam	Vietnam	BacGiang
DaNang	Vietnam	Vietnam	DaNang
Istanbul	Turkey	Turkey	Istanbul
Gwangju	SouthKorea	SouthKorea	Gwangju
Gyeongbuk	SouthKorea	SouthKorea	Gyeongbuk
Madrid	Spain	Spain	Madrid
Malindi	Kenya	Kenya	Malindi
Lebanon	Lebanon	Lebanon	Lebanon
Lipezk	Russia	Russia	Lipezk
Qingdao	China	Shandong	Qingdao
Petrozavodsk	Russia	Russia	Petrozavodsk
Penza	Russia	Russia	Penza
Navarra	Spain	Spain	Navarra
Nanjing	China	Jiangsu	Nanjing
NamDinh	Vietnam	Vietnam	NamDinh
Morioka	Japan	Iwate	Morioka
Zhuhai	China	Guangdong	Zhuhai
Yucatan	Mexico	Mexico	Yucatan
Whanganui	NewZealand	NewZealand	Whanganui
Toronto	Canada	Ontario	Toronto
Tilburg	Netherlands	Netherlands	Tilburg
Tbilisi	GeorgiaCountry	GeorgiaCountry	Tbilisi
TayNguyen	Vietnam	Vietnam	TayNguyen
Tairawhiti	NewZealand	NewZealand	Tairawhiti
Tahiti	FrenchPolynesia	FrenchPolynesia	Tahiti
Hamamatu	Japan	Shizuoka	Shizuoka
Khovd	Mongolia	Mongolia	Mongolia
Cnic	China	China	China
Sergipe	Brazil	Brazil	Sergipe
Southland	NewZealand	NewZealand	Southland
Prajianburi	Thailand	Thailand	Prajianburi
PaisVasco	Spain	Spain	PaisVasco
Pandharpur	India	India	Pandharpur
Parana	Brazil	Brazil	Parana
LangSon	Vietnam	Vietnam	LangSon
Manhean	Ghana	Ghana	Manhean
Kunming	China	Yunnan	Kunming
Kilkis	Greece	Greece	Kilkis
KhanhHoa	Vietnam	Vietnam	KhanhHoa
HoaBinh	Vietnam	Vietnam	HoaBinh
Kolkata	India	India	Kolkata
Kermanshah	Iran	Iran	Kermanshah
Kastoria	Greece	Greece	Kastoria
Jochiwon	SouthKorea	SouthKorea	Jochiwon
Mombasa	Kenya	Kenya	Mombasa
Catalonia	Spain	Spain	Catalonia
Budapest	Hungary	Hungary	Budapest
Brownsville	USA	Texas	Brownsville
Warsaw	Poland	Poland	Warsaw
Wurzburg	Germany	Germany	Wurzburg
Yakutsk	Russia	Russia	Yakutsk
Zavkhan	Mongolia	Mongolia	Zavkhan
Zhoushan	China	Zhejiang	Zhoushan
Weidu	China	Henan	Weidu
Weidong	China	Henan	Weidong
Ulyanovsk	Russia	Russia	Ulyanovsk
Utsunomiya	Japan	Tochigi	Utsunomiya
Vienna	Austria	Austria	Vienna
Turin	Italy	Italy	Turin
Trujillo	Peru	Peru	Trujillo
Tessenderlo	Belgium	Belgium	Tessenderlo
Terrassa	Spain	Spain	Terrassa
Tallinn	Estonia	Estonia	Tallinn
Taipei	Taiwan	Taiwan	Taipei
ThaiBinh	Vietnam	Vietnam	ThaiBinh
Tambov	Russia	Russia	Tambov
Shahriar	Iran	Iran	Shahriar
Strasbourg	France	France	Strasbourg
Russia	Russia	Russia	Russia
Pernambuco	Brazil	Brazil	Pernambuco
Pensacola	USA	Florida	Pensacola
Pavia	Italy	Italy	Pavia
Newark	USA	NewJersey	Newark
Neamt	Romania	Romania	Neamt
Nanchang	China	Jiangxi	Nanchang
Murmansk	Russia	Russia	Murmansk
Munich	Germany	Germany	Munich
Montreal	Canada	Quebec	Montreal
Melbourne	Australia	Victoria	Melbourne
Maramures	Romania	Romania	Maramures
Maracay	Venezuela	Venezuela	Maracay
Magadan	Russia	Russia	Magadan
Lorestan	Iran	Iran	Lorestan
Karaj	Iran	Iran	Karaj
Katerini	Greece	Greece	Katerini
Kaluga	Russia	Russia	Kaluga
Jakarta	Indonesia	Indonesia	Jakarta
Ivanovo	Russia	Russia	Ivanovo
Ilfov	Romania	Romania	Ilfov
Hvidovre	Denmark	Denmark	Hvidovre
HoChiMinh	Vietnam	Vietnam	HoChiMinh
Helsinki	Finland	Finland	Helsinki
Habana	Cuba	Cuba	Habana
Goias	Brazil	Brazil	Goias
Frankfurt	Germany	Germany	Frankfurt
Dongcheng	China	Beijing	Dongcheng
Djibouti	Djibouti	Djibouti	Djibouti
Dambovita	Romania	Romania	Dambovita
Copenhagen	Denmark	Denmark	Copenhagen
Chicago	USA	Illinois	Chicago
Cologne	Germany	Germany	Cologne
Chengdu	China	Sichuan	Chengdu
Cheboksary	Russia	Russia	Cheboksary
Buzau	Romania	Romania	Buzau
Brawley	USA	California	Brawley
Botosani	Romania	Romania	Botosani
Braila	Romania	Romania	Braila
Bishkek	Kyrgyzstan	Kyrgyzstan	Bishkek
Bethlehem	Palestine	Palestine	Bethlehem
Bethesda	USA	Maryland	Bethesda
Belgorod	Russia	Russia	Belgorod
Bayanulgii	Mongolia	Mongolia	Bayanulgii
Baofeng	China	Henan	Baofeng
Astana	Kazakhstan	Kazakhstan	Astana
Ashgabat	Turkmenistan	Turkmenistan	Ashgabat
Archangelsk	Russia	Russia	Arkhangelsk
Antwerp	Belgium	Belgium	Antwerp
Ankara	Turkey	Turkey	Ankara
Amman	Jordan	Jordan	Amman
Alagoas	Brazil	Brazil	Alagoas
Aarhus	Denmark	Denmark	Aarhus
Aalborg	Denmark	Denmark	Aalborg
Wroclaw	Poland	Poland	Wroclaw
Volgograd	Russia	Russia	Volgograd
Vladivistok	Russia	Russia	Vladivistok
Trabzon	Turkey	Turkey	Trabzon
TayNinh	Vietnam	Vietnam	TayNinh
Taizhou	China	Zhejiang	Taizhou
Sulaimani	Iraq	Iraq	Sulaimani
Suceava	Romania	Romania	Suceava
StEtienne	France	France	StEtienne
Stavropol	Russia	Russia	Stavropol
Serres	Greece	Greece	Serres
Salaj	Romania	Romania	Salaj
Rennes	France	France	Rennes
Rabat	Morocco	Morocco	Rabat
Prahova	Romania	Romania	Prahova
Poland	Poland	Poland	Poland
Piaui	Brazil	Brazil	Piaui
Palermo	Italy	Italy	Palermo
Orenburg	Russia	Russia	Orenburg
Odense	Denmark	Denmark	Odense
Monterrey	Mexico	Mexico	Monterrey
Merida	Mexico	Mexico	Merida
Medellin	Colombia	Colombia	Medellin
Lishui	China	Zhejiang	Lishui
Larisa	Greece	Greece	Larisa
Korlebu	Ghana	Ghana	Korlebu
Kavala	Greece	Greece	Kavala
Karasuk	Russia	Russia	Karasuk
Jinhua	China	Zhejiang	Jinhua
Jiangyin	China	Jiangsu	Jiangyin
Jeonnam	SouthKorea	SouthKorea	Jeonnam
Izhevsk	Russia	Russia	Izhevsk
Harghita	Romania	Romania	Harghita
Hamburg	Germany	Germany	Hamburg
Haishu	China	Zhejiang	Haishu
Giannitsa	Greece	Greece	Giannitsa
Gdansk	Poland	Poland	Gdansk
Covasna	Romania	Romania	Covasna
Changchun	China	Jilin	Changchun
Xuchang	China	Henan	Xuchang
Xigong	China	Henan	Xigong
Valencia	Spain	Spain	Valencia
Saratov	Russia	Russia	Saratov
Ptolemaida	Greece	Greece	Ptolemaida
Anadyr	Russia	Russia	Anadyr
Bryansk	Russia	Russia	Bryansk
Brasov	Romania	Romania	Brasov
Bochum	Germany	Germany	Bochum
Bamako	Mali	Mali	Bamako
Bihor	Romania	Romania	Bihor
Blagovechensk	Russia	Russia	Blagovechensk
Zhongyuan	China	Henan	Zhongyuan
Almaty	Kazakhstan	Kazakhstan	Almaty
Selenge	Mongolia	Mongolia	Selenge
Riyadh	SaudiArabia	SaudiArabia	Riyadh
Chantaburi	Thailand	Thailand	Chantaburi
Arvaikheer	Mongolia	Mongolia	Arvaikheer
France	France	France	France
Kenitra	Morocco	Morocco	Kenitra
Lithuania	Lithuania	Lithuania	Lithuania
Marrakech	Morocco	Morocco	Marrakech
EspiritoSanto	Brazil	Brazil	EspiritoSanto
Charlottesville	USA	Virginia	Charlottesville
Astrahan	Russia	Russia	Astrahan
Belize	Belize	Belize	Belize
Brunei	Brunei	Brunei	Brunei
Chambery	France	France	Chambery
Changwon	SouthKorea	SouthKorea	Changwon
Kyounggi	SouthKorea	SouthKorea	Kyounggi
Kyongnam	SouthKorea	SouthKorea	Kyongnam
Inchon	SouthKorea	SouthKorea	SouthKorea
Madang	PapuaNewGuinea	PapuaNewGuinea	Madang
Mangua	Nicaragua	Nicaragua	Mangua
Middleburg	SouthAfrica	SouthAfrica	Middleburg
Bucharest	Romania	Romania	Bucharest
Calarasi	Romania	Romania	Calarasi
Granada	Spain	Spain	Granada
Mendoza	Argentina	Argentina	Mendoza
Tucuman	Argentina	Argentina	Tucuman
Surabaya	Indonesia	Indonesia	Surabaya
Shijiazhuang	China	Hebei	Shijiazhuang
Thueringen	Germany	Germany	Thueringen
Pretoria	SouthAfrica	SouthAfrica	Pretoria
Neuquen	Argentina	Argentina	Neuquen
RioGdoSul	Brazil	Brazil	RioGrandeDoSul
Niedersachsen	Germany	Germany	Niedersachsen
Ucayali	Peru	Peru	Ucayali
Misiones	Argentina	Argentina	Misiones
MadreDeDios	Peru	Peru	MadreDeDios
Pachgani	India	India	Pachgani
Kadoma	Zimbabwe	Zimbabwe	Kadoma
Craiova	Romania	Romania	Craiova
Soligorsk	Belarus	Belarus	Soligorsk
Lazio	Italy	Italy	Lazio
Mogilev	Belarus	Belarus	Mogilev
Vologda	Russia	Russia	Vologda
Rochester	USA	NewYork	Rochester
Nashville	USA	Tennessee	Nashville
Zarumilla	Peru	Peru	Zarumilla
Valdivia	Chile	Chile	Valdivia
Lusaka	Zambia	Zambia	Lusaka
Hunedoara	Romania	Romania	Hunedoara
Zaporizza	Ukraine	Ukraine	Zaporizza
Thessalonika	Greece	Greece	Thessalonika
Misawa	Japan	Aomori	Misawa
Kamata	Japan	Tokyo	Kamata
Yangon	Myanmar	Myanmar	Yangon
Nyiregyhaza	Hungary	Hungary	Nyiregyhaza
Naypyitaw	Myanmar	Myanmar	Naypyitaw
Lesvos	Greece	Greece	Lesvos
Podgorica	Montenegro	Montenegro	Podgorica
Morocco	Morocco	Morocco	Morocco
Coted'Ivoire	IvoryCoast	IvoryCoast	IvoryCoast
Cote_d_Ivoire	IvoryCoast	IvoryCoast	IvoryCoast
Cote-dIvoire	IvoryCoast	IvoryCoast	IvoryCoast
Cote-d'Ivoire	IvoryCoast	IvoryCoast	IvoryCoast
Cote_d'Ivoire	IvoryCoast	IvoryCoast	IvoryCoast
Hong_Kong	HongKong	HongKong	HongKong
New_York	USA	NewYork	NewYork
New-York	USA	NewYork	NewYork
Sri_Lanka	SriLanka	SriLanka	SriLanka
El_Salvador	ElSalvador	ElSalvador	ElSalvador
Rhode_Island	USA	RhodeIsland	RhodeIsland
District_of_Columbia	USA	DistrictOfColumbia	DistrictOfColumbia
District-of-Columbia	USA	DistrictOfColumbia	DistrictOfColumbia
South_Australia	Australia	SouthAustralia	SouthAustralia
South-Australia	Australia	SouthAustralia	SouthAustralia
Hong-Kong	HongKong	HongKong	HongKong
Surat_Thani	Thailand	Thailand	SuratThani
Western_Sepik	PapuaNewGuinea	PapuaNewGuinea	WesternSepik
Western-Sepik	PapuaNewGuinea	PapuaNewGuinea	WesternSepik
Port-Moresby	PapuaNewGuinea	PapuaNewGuinea	PortMoresby
Costa_Rica	CostaRica	CostaRica	CostaRica
New_Jersey	USA	NewJersey	NewJersey
New-Jersey	USA	NewJersey	NewJersey
North_Dakota	USA	NorthDakota	NorthDakota
North-Dakota	USA	NorthDakota	NorthDakota
British_Columbia	Canada	BritishColumbia	Canada
South_Carolina	USA	SouthCarolina	SouthCarolina
South-Carolina	USA	SouthCarolina	SouthCarolina
North_Carolina	USA	NorthCarolina	NorthCarolina
North-Carolina	USA	NorthCarolina	NorthCarolina
Puerto_Rico	PuertoRico	PuertoRico	PuertoRico
Puerto-Rico	PuertoRico	PuertoRico	PuertoRico
St._Petersburg	Russia	Russia	StPetersburg
St.-Petersburg	Russia	Russia	StPetersburg
St_Petersburg	Russia	Russia	StPetersburg
St-Petersburg	Russia	Russia	StPetersburg
St.Petersburg	Russia	Russia	StPetersburg
Saint_Petersburg	Russia	Russia	StPetersburg
Saint-Petersburg	Russia	Russia	StPetersburg
Cayman_Islands	CaymanIslands	CaymanIslands	CaymanIslands
New_Hampshire	USA	NewHampshire	NewHampshire
New-Hampshire	USA	NewHampshire	NewHampshire
South_Dakota	USA	SouthDakota	SouthDakota
South-Dakota	USA	SouthDakota	SouthDakota
Ulan_Ude	Russia	Russia	UlanUde
Ulan-Ude	Russia	Russia	UlanUde
Rheinland-Pfalz	Germany	Germany	RheinlandPfalz
Baden-Wuerttemburg	Germany	Germany	BadenWurttemberg
Baden_Wurttemberg	Germany	Germany	BadenWurttemberg
Baden_Wuerttemberg	Germany	Germany	BadenWurttemberg
Baden-Wuerttemberg	Germany	Germany	BadenWurttemberg
Nong_Khai	Thailand	Thailand	NongKhai
New-Caledonia	NewCaledonia	NewCaledonia	NewCaledonia
New_Caledonia	NewCaledonia	NewCaledonia	NewCaledonia
Cape_Town	SouthAfrica	SouthAfrica	CapeTown
Cape-Town	SouthAfrica	SouthAfrica	CapeTown
Nordrhein-Westfalen	Germany	Germany	NordrheinWestfalen
Nong-Khai	Thailand	Thailand	NongKhai
Costa-Rica	CostaRica	CostaRica	CostaRica
Mae-Hong-Son	Thailand	Thailand	MaeHongSon
Alice-Springs	Australia	NorthernTerritory	AliceSprings
Baden-Wurttemberg	Germany	Germany	BadenWurttemberg
Lop-Buri	Thailand	Thailand	LopBuri
Dominican-Republic	DominicanRepublic	DominicanRepublic	DominicanRepublic
Solomon-Islands	SolomonIslands	SolomonIslands	SolomonIslands
Solomon_Islands	SolomonIslands	SolomonIslands	SolomonIslands
West-Virginia	USA	WestVirginia	WestVirginia
West_Virginia	USA	WestVirginia	WestVirginia
El-Salvador	ElSalvador	ElSalvador	ElSalvador
Sri-Lanka	SriLanka	SriLanka	SriLanka
Northern-Marianas-Islands	NorthernMarianaIslands	NorthernMarianaIslands	NorthernMarianaIslands
Northern-Mariana-Islands	NorthernMarianaIslands	NorthernMarianaIslands	NorthernMarianaIslands
Northern_Mariana_Islands	NorthernMarianaIslands	NorthernMarianaIslands	NorthernMarianaIslands
Western-Australia	Australia	WesternAustralia	WesternAustralia
Rhode-Island	USA	RhodeIsland	RhodeIsland
British-Columbia	Canada	BritishColumbia	BritishColumbia
Ribeirao-Preto	Brazil	Brazil	RibeiraoPreto
Kwazulu-Natal	SouthAfrica	SouthAfrica	KwaZuluNatal
Chiang-Rai	Thailand	Thailand	ChiangRai
Nei-Mongol	China	Neimenggu	Neimenggu
Surat-Thani	Thailand	Thailand	SuratThani
Bay_of_Plenty	NewZealand	NewZealand	BayOfPlenty
Rio_de_Janeiro	Brazil	Brazil	RioDeJaneiro
San_Salvador	ElSalvador	ElSalvador	SanSalvador
Santo_Domingo	DominicanRepublic	DominicanRepublic	SantoDomingo
West_Coast	NewZealand	NewZealand	WestCoast
United_Kingdom	UnitedKingdom	UnitedKingdom	UnitedKingdom
South_Africa	SouthAfrica	SouthAfrica	SouthAfrica
Minas_Gerais	Brazil	Brazil	MinasGerais
Nakhon_Ratachasima	Thailand	Thailand	NakhonRatachasima
Nelson_Marlborough	NewZealand	NewZealand	NelsonMarlborough
Silver_Spring	USA	Maryland	SilverSpring
Sao_Paulo	Brazil	Brazil	SaoPaulo
San_Diego	USA	California	SanDiego
Santa_Catarina	Brazil	Brazil	SantaCatarina
San_Antonio	USA	Texas	SanAntonio
Rio_Grande_do_Sul	Brazil	Brazil	RioGrandeDoSul
North_Fitzroy	Australia	Victoria	NorthFitzroy
Los_Angeles	USA	California	LosAngeles
Mato_Grosso	Brazil	Brazil	MatoGrosso
Distrito_Federal	Brazil	Brazil	DistritoFederal
Ft_Carson	USA	Colorado	FortCarson
Czech_Republic	CzechRepublic	CzechRepublic	CzechRepublic
Cherry_Point	USA	NorthCarolina	CherryPoint
Central_African_Republic	CentralAfricanRepublic	CentralAfricanRepublic	CentralAfricanRepublic
Castilla_La_Mancha	Spain	Spain	CastillaLaMancha
Caras_Severin	Romania	Romania	CarasSeverin
Bandar_Abbas	Iran	Iran	BandarAbbas
Addis_Ababa	Ethiopia	Ethiopia	AddisAbaba
Santa_Cruz	Bolivia	Bolivia	SantaCruz
Sachsen_Anhalt	Germany	Germany	SachsenAnhalt
Ruzhou	China	Henan	Ruzhou
Rostov_oblast	Russia	Russia	Rostov
Puerto_Montt	Chile	Chile	PuertoMontt
Port_Au_Prince	Haiti	Haiti	PortAuPrince
Pais_Vasco	Spain	Spain	PaisVasco
La_Paz	Bolivia	Bolivia	LaPaz
Khon_Kaen	Thailand	Thailand	KhonKaen
Joshkar_Ola	Russia	Russia	YoshkarOla
Ft.Benning	USA	Georgia	FortBenning
Bistrita_Nasaud	Romania	Romania	BistritaNasaud
Cape_May	USA	NewJersey	CapeMay
Canada_SK	Canada	Saskatchewan	Saskatchewan
Canada_QC	Canada	Quebec	Quebec
Canada_ON	Canada	Ontario	Ontario
Canada_NWT	Canada	NorthwestTerritories	NorthwestTerritories
Canada_NFL	Canada	NewfoundlandAndLabrador	NewfoundlandAndLabrador
Canada_NB	Canada	NewBrunswick	NewBrunswick
Canada_PQ	Canada	Quebec	Quebec
Canada_MB	Canada	Manitoba	Manitoba
Canada_BC	Canada	BritishColumbia	BritishColumbia
Canada_AB	Canada	Alberta	Alberta
Canada_NS	Canada	NovaScotia	NovaScotia
Espirito_Santo	Brazil	Brazil	EspiritoSanto
Buenos_Aires	Brazil	Brazil	BuenosAires
Cayman-Islands	CaymanIslands	CaymanIslands	CaymanIslands
New_South_Wales	Australia	NewSouthWales	NewSouthWales
New-South-Wales	Australia	NewSouthWales	NewSouthWales
Western_Australia	Australia	WesternAustralia	WesternAustralia
Mecklenburg_Vorpommern	Germany	Germany	MecklenburgVorpommern
Mar_del_Plata	Argentina	Argentina	MarDelPlata
Santa_Fe	USA	NewMexico	SantaFe
La_Plata	Argentina	Argentina	LaPlata
Nordrhein_Westfalen	Germany	Germany	NordrheinWestfalen
Hung_Yen	Vietnam	Vietnam	HungYen
Tay_Nguyen	Vietnam	Vietnam	TayNguyen
Madre_de_Dios	Peru	Peru	MadreDeDios
Cook_Islands	CookIslands	CookIslands	CookIslands
Saudi_Arabia	SaudiArabia	SaudiArabia	SaudiArabia
Saudi-Arabia	SaudiArabia	SaudiArabia	SaudiArabia
Petropavlovsk-Kamchatski	Russia	Russia	PetropavlovskKamchatski
St_Lucia	SaintLucia	SaintLucia	SaintLucia
Chan_Thaburi	Thailand	Thailand	ChanThaburi
St.Louis	USA	Missouri	StLouis
/Dolj/	Romania	Romania	Dolj
/Orchon/	Mongolia	Mongolia	Orchon
/Canada/	Canada	Canada	Canada
/Awb/	India	India	Awb
/Hnl/	India	India	Hnl
/Blore/	India	India	Blore
/Castro/	Chile	Chile	Castro
/Ngp/	India	India	Ngp
/Olt/	Romania	Romania	Olt
/Ghom/	Iran	Iran	Ghom
/Kol/	India	India	Kol
/Lagos/	Nigeria	Nigeria	Lagos
/Mures/	Romania	Romania	Mures
/Nsk/	India	India	Nsk
/Orel/	Russia	Russia	Orel
/Arad/	Romania	Romania	Arad
/Bari/	Italy	Italy	Bari
/Bonn/	Germany	Germany	Bonn
/Iran/	Iran	Iran	Iran
/Lima/	Peru	Peru	Lima
/Lur/	India	India	Lur
/Mum/	India	India	Mum
/Perm/	Russia	Russia	Perm
/Rome/	Italy	Italy	Rome
/Timis/	Romania	Romania	Timis
/Vadu/	India	India	Vadu
/Ufa/	Russia	Russia	Ufa
/Tver/	Russia	Russia	Tver
/Ulgii/	Mongolia	Mongolia	Ulgii
/USA/	USA	USA	USA
/Hutt/	NewZealand	NewZealand	Hutt
/Hue/	Vietnam	Vietnam	Hue
/HaNam/	Vietnam	Vietnam	HaNam
/Australia/	Australia	Australia	Australia
/Che/	India	India	Che
/Rtng/	India	India	Rtng
/Bcm/	USA	Texas	Houston
/Casa/	Morocco	Morocco	Casablanca
/Chaco/	Argentina	Argentina	Chaco
/Caen/	France	France	Caen
/Malmo/	Sweden	Sweden	Malmo
/Salta/	Argentina	Argentina	Salta
/HungYen/	Vietnam	Vietnam	HungYen
/Wuxi/	China	Jiangsu	Jiangsu
/Daeku/	SouthKorea	SouthKorea	Daeku
/Trento/	Italy	Italy	Trento
/Durban/	SouthAfrica	SouthAfrica	Durban
/Chonnam/	SouthKorea	SouthKorea	Chonnam
CHAMCHAMAYO	Peru	Peru	Chanchamayo
NNOVGOROD	Russia	Russia	Novgorod
Chachamayo	Peru	Peru	Chanchamayo
Surinami	Suriname	Suriname	Suriname
Shannxi	China	Shaanxi	Shaanxi
TAIWN	Taiwan	Taiwan	Taiwan
STACATARINA	Brazil	Brazil	SantaCatarina
BRUSSEL	Belgium	Belgium	Brussels
KYONGGI	SouthKorea	SouthKorea	Gyeonggi
PHILLIPPNES	Philippines	Philippines	Philippines
NEIMENG	China	Neimenggu	Neimenggu
Uvurkhagai	Mongolia	Mongolia	Uvurkhangai
Singpaore	Singapore	Singapore	Singapore
Salehard	Russia	Russia	Salekhard
New_Mexcio	USA	NewMexico	NewMexico
/Kouchi/	Japan	Kochi	Kochi
Delware	USA	Delaware	Delaware
Shangdong	China	Shandong	Shandong
RioGdeSul	Brazil	Brazil	RioGrandeDoSul
Guanxi	China	Guangxi	Guangxi
NEWsYORK	USA	NewYork	NewYork
Jinlin	China	Jilin	Jilin
Kalingrad	Russia	Russia	Kaliningrad
A/CN/17/96	Canada	Canada	Canada
A/CN/27/96	Canada	Canada	Canada
A/CN/61/96	Canada	Canada	Canada
A/TX/9/96	USA	Texas	Texas
A/KO/671/97	SouthKorea	SouthKorea	SouthKorea
A/KO/679/97	SouthKorea	SouthKorea	SouthKorea
A/CA/13/96	USA	California	California
A/TH/78/97	Thailand	Thailand	Thailand
A/TH/79/97	Thailand	Thailand	Thailand
A/MN/1/97	USA	Minnesota	Minnesota
A/MN/1/96	USA	Minnesota	Minnesota
A/JA/416/97	Japan	Japan	Japan
A/MO/10/96	USA	Missouri	Missouri
A/MO/11/96	USA	Missouri	Missouri
A/AG/39/96	Argentina	Argentina	Argentina
A/AG/201/96	Argentina	Argentina	Argentina
A/AG/607/96	Argentina	Argentina	Argentina
A/NY/55/96	USA	NewYork	NewYork
A/NY/50/96	USA	NewYork	NewYork
A/NJ/8/96	USA	NewJersey	NewJersey
A/HK/387/97	HongKong	HongKong	HongKong
A/BR/43/97	Brazil	Brazil	Brazil
CHU/2-524/2005	SouthKorea	SouthKorea	SouthKorea
DC-AHERN-L	USA	DistrictOfColumbia	DistrictOfColumbia
UK/1861-CDC-20030709-ROW-12/2003	UnitedKingdom	UnitedKingdom	UnitedKingdom
A/GUANGER/227/2000	China	China	China
A/MO/6/96	USA	Missouri	Missouri
A/JA/99/96	Japan	Japan	Japan
A/RI/7/97	USA	RhodeIsland	RhoseIsland
A/NL/365/2007	Netherlands	Netherlands	Netherlands
A/West-Coast/31/2001	NewZealand	NewZealand	NewZealand
A/West-Coast/33/2001	NewZealand	NewZealand	NewZealand
A/PA/2/97	USA	Pennsylvania	Pennsylvania
A/BR/87/96	Brazil	Brazil	Brazil
A/CO/11/96	USA	Colorado	Colorado
B/M/09882/2008	India	India	India
B/M/09883/2008	India	India	India
B/M/09883/201008	India	India	India
B/M/09882/180908	India	India	India
HK/120/2009	HongKong	HongKong	HongKong
A/WA/5/96	USA	Washington	Washington
A/TX/11/96	USA	Texas	Texas
A/VN/1249/2001	Vietnam	Vietnam	Vietnam
A/VN/1293/2001	Vietnam	Vietnam	Vietnam
A/DE/4/97	USA	Delaware	Delaware
^DO-	DominicanRepublic	DominicanRepublic	DominicanRepublic
^CS-	CostaRica	CostaRica	CostaRica
^ET-	Ethiopia	Ethiopia	Ethiopia
^TD-	TrinidadTobago	TrinidadTobago	TrinidadTobago
^TX-	USA	Texas	Texas
^NJ-	USA	NewJersey	NewJersey
^WI-	USA	Wisconsin	Wisconsin
^VA-	USA	Virginia	Virginia
^AZ-	USA	Arizona	Arizona
^CL-	Colombia	Colombia	Colombia
^AG-	Argentina	Argentina	Argentina
^NY-	USA	NewYork	NewYork
^KS-	USA	Kansas	Kansas
^TW-	Taiwan	Taiwan	Taiwan
^IA-	USA	Iowa	Iowa
^EG-	Egypt	Egypt	Egypt
^GE-	Germany	Germany	Germany
^UA-	Ukraine	Ukraine	Ukraine
^NC-	USA	NorthCarolina	NorthCarolina
^BA-	Bangladesh	Bangladesh	Bangladesh
^HI-	USA	Hawaii	Hawaii
^TH-	Thailand	Thailand	Thailand
^KO-	SouthKorea	SouthKorea	SouthKorea
^PE-	Peru	Peru	Peru
^CN-	Canada	Canada	Canada
^WY-	USA	Wyoming	Wyoming
^WV-	USA	WestVirginia	WestVirginia
^II-	India	India	India
^UY-	Uruguay	Uruguay	Uruguay
^LA-	USA	Louisiana	Louisiana
^FG-	FrenchGuiana	FrenchGuiana	FrenchGuiana
^CI-	Chile	Chile	Chile
^NE-	USA	Nebraska	Nebraska
^MX-	Mexico	Mexico	Mexico
^JA-	Japan	Japan	Japan
^NH-	USA	NewHampshire	NewHampshire
^BR-	Brazil	Brazil	Brazil
^IN-	USA	Indiana	Indiana
^FL-	USA	Florida	Florida
^BL-	Bolivia	Bolivia	Bolivia
^CT-	USA	Connecticut	Connecticut
^SD-	USA	SouthDakota	SouthDakota
^RI-	USA	RhodeIsland	RhodeIsland
^NP-	Nepal	Nepal	Nepal
^VE-	Venezuela	Venezuela	Venezuela
^AK-	USA	Alaska	Alaska
^GA-	USA	Georgia	Georgia
^MI-	USA	Michigan	Michigan
^SR-	SaudiArabia	SaudiArabia	SaudiArabia
^WA-	USA	Washington	Washington
^PA-	USA	Pennsylvania	Pennsylvania
^SC-	USA	SouthCarolina	SouthCarolina
^ID-	USA	Idaho	Idaho
^MN-	USA	Minnesota	Minnesota
^OK-	USA	Oklahoma	Oklahoma
^TN-	USA	Tennessee	Tennessee
^MT-	USA	Montana	Montana
^CO-	USA	Colorado	Colorado
^RO-	Romania	Romania	Romania
^MO-	USA	Missouri	Missouri
^TU-	Turkey	Turkey	Turkey
^IT-	Italy	Italy	Italy
^MD-	USA	Maryland	Maryland
^OH-	USA	Ohio	Ohio
^UT-	USA	Utah	Utah
^NV-	USA	Nevada	Nevada
^AR-	USA	Arkansas	Arkansas
^ME-	USA	Maine	Maine
^PY-	Paraguay	Paraguay	Paraguay
^HK-	HongKong	HongKong	HongKong
^GQ-	Guam	Guam	Guam
^MA-	USA	Massachusetts	Massachusetts
^NM-	USA	NewMexico	NewMexico
^CA-	USA	California	California
^VT-	USA	Vermont	Vermont
^OR-	USA	Oregon	Oregon
^MS-	USA	Mississippi	Mississippi
^KY-	USA	Kentucky	Kentucky
^ND-	USA	NorthDakota	NorthDakota
^JM-	Jamaica	Jamaica	Jamaica
^HO-	Honduras	Honduras	Honduras
^AL-	USA	Alabama	Alabama
^PR-	PuertoRico	PuertoRico	PuertoRico
^GT-	Guatemala	Guatemala	Guatemala
^LO-	Laos	Laos	Laos
^CB-	Cambodia	Cambodia	Cambodia
^VN-	Vietnam	Vietnam	Vietnam
^KR-	Kyrgyzstan	Kyrgyzstan	Kyrgyzstan
^DR-	DominicanRepublic	DominicanRepublic	DominicanRepublic
^KN-	Kenya	Kenya	Kenya
^OM-	Oman	Oman	Oman
^BT-	Bhutan	Bhutan	Bhutan
^PH-	Philippines	Philippines	Philippines
^ES-	ElSalvador	ElSalvador	ElSalvador
^SU-	Suriname	Suriname	Suriname
^EC-	Ecuador	Ecuador	Ecuador
^NU-	Nicaragua	Nicaragua	Nicaragua
^DE-	USA	Delaware	Delaware
^UG-	Uganda	Uganda	Uganda
^IL-	USA	Illinois	Illinois
^HA-	Haiti	Haiti	Haiti
^SA-	SouthAfrica	SouthAfrica	SouthAfrica
^NI-	Nigeria	Nigeria	Nigeria
^PI-	Micronesia	Micronesia	Micronesia
/Canada/	Canada	Canada	Canada
/China/	China	China	China
/HK/	HongKong	HongKong	HongKong
^HK/	HongKong	HongKong	HongKong
/NY/	USA	NewYork	NewYork
/Pach/	India	India	India
/VD/	India	India	India
/KL/	India	India	India
/TW/	Taiwan	Taiwan	Taiwan
^Caen/	France	France	Caen
^Canada/	Canada	Canada	Canada
^Malmo/	Sweden	Sweden	Malmo
Hebei	China	Hebei	Hebei
Dominica	DominicanRepublic	DominicanRepublic	DominicanRepublic
India	India	India	India
Virginia	USA	Virginia	Virginia
Anhui	China	Anhui	Anhui
Kansas	USA	Kansas	Kansas
Xian	China	Shaanxi	Xian
Changsha	China	Hunan	Changsha
Oman	Oman	Oman	Oman
Roma	Italy	Italy	Rome
Peru	Peru	Peru	Peru
Quito	Ecuador	Ecuador	Quito
Sachsen	Germany	Germany	Germany
Tak	Thailand	Thailand	Tak
LongAn	Vietnam	Vietnam	LongAn
Shiga	Japan	Shiga	Shiga
Hangzhou	China	Zhejiang	Hangzhou
Fuzhou	China	Fujian	Fuzhou
Hainan	China	Hainan	Hainan
Viet_Nam	Vietnam	Vietnam	Vietnam
Bavaria	Germany	Germany	Bavaria
Craven	UnitedKingdom	UnitedKingdom	Craven
Palau	Palau	Palau	Palau
Cote_Divoire	IvoryCoast	IvoryCoast	IvoryCoast
New_Zealand	NewZealand	NewZealand	NewZealand
Malta	Malta	Malta	Malta
Montenegro	Montenegro	Montenegro	Montenegro
Pakistan	Pakistan	Pakistan	Pakistan
Bermuda	Bermuda	Bermuda	Bermuda
Port_Moresby	PapuaNewGuinea	PapuaNewGuinea	PortMoresby
Reunion	Reunion	Reunion	Reunion
British_Virgin_Islands	BritishVirginIslands	BritishVirginIslands	BritishVirginIslands
American_Samoa	AmericanSamoa	AmericanSamoa	AmericanSamoa
Tajikistan	Tajikistan	Tajikistan	Tajikistan
Serbia	Serbia	Serbia	Serbia
Senegal	Senegal	Senegal	Senegal
Yokosuka	Japan	Kanagawa	Yokosuka
Phuket	Thailand	Thailand	Thailand
SouthAfrica	SouthAfrica	SouthAfrica	SouthAfrica
NewZealand	NewZealand	NewZealand	NewZealand
Bahrain	Bahrain	Bahrain	Bahrain
Kazakstan	Kazakhstan	Kazakhstan	Kazakhstan
BurkinaFaso	BurkinaFaso	BurkinaFaso	BurkinaFaso
Uppsala	Sweden	Sweden	Uppsala
Gainesville	USA	Florida	Gainesville
BayOfPlenty	NewZealand	NewZealand	BayOfPlenty
Prievidza	Slovakia	Slovakia	Prievidza
Sibiu	Romania	Romania	Sibiu
Sukhothai	Thailand	Thailand	Sukhothai
Irkutsk	Russia	Russia	Irkutsk
Kragujevac	Serbia	Serbia	Kragujevac
Kosice	Slovakia	Slovakia	Kosice
Lorraine	France	France	Lorraine
Niakhar	Senegal	Senegal	Niakhar
Togo	Togo	Togo	Togo
Gambia	Gambia	Gambia	Gambia
Prachuapkhirikhan	Thailand	Thailand	Prachuapkhirikhan
Asturias	Spain	Spain	Asturias
Curico	Chile	Chile	Curico
Bulgan	Mongolia	Mongolia	Bulgan
Trencin	Slovakia	Slovakia	Trencin
Burkina_Faso	BurkinaFaso	BurkinaFaso	BurkinaFaso
Arkadia.GR	Greece	Greece	Arkadia.GR
Lamia.GR	Greece	Greece	Lamia.GR
Astros.GR	Greece	Greece	Astros.GR
Indore	India	India	Indore
Matagalpa	Nicaragua	Nicaragua	Matagalpa
Saipan	NorthernMarianaIslands	NorthernMarianaIslands	Saipan
Vaslui	Romania	Romania	Vaslui
Segovia	Spain	Spain	Segovia
Syktyvkar	Russia	Russia	Syktyvkar
Akhaltsikhe	GeorgiaCountry	GeorgiaCountry	Akhaltsikhe
Kirov	Russia	Russia	Kirov
Plzen	CzechRepublic	CzechRepublic	Plzen
Tubas	Palestine	Palestine	Tubas
Majkop	Russia	Russia	Majkop
Hebron	Palestine	Palestine	Hebron
Kazan	Russia	Russia	Kazan
Burgos	Spain	Spain	Burgos
Sarajevo	BosniaHerzegovina	BosniaHerzegovina	Sarajevo
Para	Brazil	Brazil	Para
Ramallah	Palestine	Palestine	Ramallah
Qalqilia	Palestine	Palestine	Qalqilia
Tulkarm	Palestine	Palestine	Tulkarm
Jericho	Palestine	Palestine	Jericho
Hormozgan	Iran	Iran	Hormozgan
Westmead	Australia	NewSouthWales	Westmead
Darlinghurst	Australia	NewSouthWales	Darlinghurst
Brooklyn	USA	NewYork	Brooklyn
Freiburg	Germany	Germany	Freiburg
Ho_Chi_Minh	Vietnam	Vietnam	HoChiMinh
Kowloon	HongKong	HongKong	Kowloon
Srinigar	India	India	Srinagar
Thesssaloniki	Greece	Greece	Thesssaloniki
Yaounde	Cameroon	Cameroon	Yaounde
Bronx	USA	NewYork	Bronx
Hevecam	Cameroon	Cameroon	Hevecam
Micronesia	Micronesia	Micronesia	Micronesia
Gothenburg	Sweden	Sweden	Gothenburg
Klaipeda	Lithuania	Lithuania	Klaipeda
Kordestan	Iran	Iran	Kurdistan
Telsiai	Lithuania	Lithuania	Telsiai
Palencia	Spain	Spain	Palencia
Ioannina	Greece	Greece	Ioannina
Jeddah	SaudiArabia	SaudiArabia	Jeddah
Burdur	Turkey	Turkey	Burdur
Colombo	SriLanka	SriLanka	Colombo
Dundgobi	Mongolia	Mongolia	Dundgobi
Linares	Spain	Spain	Linares
Santa_Clara	USA	California	SantaClara
Nauru	Micronesia	Micronesia	Nauru
Nablus	Palestine	Palestine	Nablus
Jenin	Palestine	Palestine	Jenin
Yopougon	IvoryCoast	IvoryCoast	Yopougon
Minneapolis	USA	Minnesota	Minneapolis
Skopje	Macedonia	Macedonia	Skopje
Dmanisi	GeorgiaCountry	GeorgiaCountry	Dmanisi
Khobi	GeorgiaCountry	GeorgiaCountry	Khobi
Corrientes	Argentina	Argentina	Corrientes
Rio_Grande_do_Norte	Brazil	Brazil	RioGrandeDoNorte
Kastamonu	Turkey	Turkey	Kastamonu
Samoa	AmericanSamoa	AmericanSamoa	AmericanSamoa
Headington	UnitedKingdom	UnitedKingdom	Headington
Croatia	Croatia	Croatia	Croatia
Armenia	Armenia	Armenia	Armenia
Mahajanga	Madagascar	Madagascar	Mahajanga
Larissa	Greece	Greece	Larissa
Giessen	Germany	Germany	Giessen
Nunavut	Canada	Nunavut	Nunavut
Canada_NU	Canada	Nunavut	Nunavut
Saint_Lucia	SaintLucia	SaintLucia	SaintLucia
Turks_And_Caicos_Islands	TurksCaicosIslands	TurksCaicosIslands	TurksCaicosIslands
Bosnia_And_Herzegovina	BosniaHerzegovina	BosniaHerzegovina	BosniaHerzegovina
Barnaul	Russia	Russia	Barnaul
Vanimo	PapuaNewGuinea	PapuaNewGuinea	Vanimo
Karapitiya	SriLanka	SriLanka	Karapitiya
Trikala	Greece	Greece	Trikala
Tokat	Turkey	Turkey	Tokat
Jabalpur	India	India	Jabalpur
Ruyang	China	Henan	Ruyang
Pohnpei	Micronesia	Micronesia	Pohnpei
Modra	Slovakia	Slovakia	Modra
Kosrae	Micronesia	Micronesia	Kosrae
Tumen	China	Jilin	Tumen
Matara	SriLanka	SriLanka	Matara
Malatya	Turkey	Turkey	Malatya
Kirklareli	Turkey	Turkey	Kirklareli
Tekirdag	Turkey	Turkey	Tekirdag
Kaunas	Lithuania	Lithuania	Kaunas
Marivan	Iran	Iran	Marivan
Ardebil	Iran	Iran	Ardebil
Veria	Greece	Greece	Veria
Sanandaj	Iran	Iran	Sanandaj
Alborz	Iran	Iran	Alborz
Pays_De_La_Loire	France	France	PaysDeLaLoire
Douala	Cameroon	Cameroon	Douala
Tocantins	Brazil	Brazil	Tocantins
Formosa	Argentina	Argentina	Formosa
Nord_Pas-De-Calais	France	France	NordPasDeCalais
NoveZamky	Slovakia	Slovakia	NoveZamky
HuttValley	NewZealand	NewZealand	HuttValley
HauteNormandie	France	France	HauteNormandie
Catamarca	Argentina	Argentina	Catamarca
Chiang_Rai	Thailand	Thailand	ChiangRai
Annaba	Algeria	Algeria	Annaba
Blida	Algeria	Algeria	Blida
Salfit	Palestine	Palestine	Salfit
Cheb	CzechRepublic	CzechRepublic	Cheb
Ohrid	Macedonia	Macedonia	Ohrid
Zanjan	Iran	Iran	Zanjan
Tetovo	Macedonia	Macedonia	Tetovo
Gostivar	Macedonia	Macedonia	Gostivar
Strumica	Macedonia	Macedonia	Strumica
Aveiro	Portugal	Portugal	Aveiro
Chiatura	GeorgiaCountry	GeorgiaCountry	Chiatura
Coimbra	Portugal	Portugal	Coimbra
Levice	Slovakia	Slovakia	Levice
Portalegre	Portugal	Portugal	Portalegre
Tsqaltubo	GeorgiaCountry	GeorgiaCountry	Tsqaltubo
Castelo_Branco	Portugal	Portugal	CasteloBranco
Rathnapura	SriLanka	SriLanka	Ratnapura
PaysDeLoire	France	France	PaysDeLaLoire
Kobuleti	GeorgiaCountry	GeorgiaCountry	Kobuleti
Hradec_Kralove	CzechRepublic	CzechRepublic	HradecKralove
Adjame	IvoryCoast	IvoryCoast	Adjame
Soria	Spain	Spain	Soria
Antalya	Turkey	Turkey	Antalya
